s,s,s,s,s,s,s,a,a,a,s,s,s,s,s,s,s,s,s,s,
d,a,e,a,a,a,a,a,a,a,a,a,a,a,a,a,a,a,a,s,
d,a,e,s,a,a,a,a,a,a,a,a,a,a,a,a,a,a,a,s,
d,a,e,s,s,a,a,a,s,a,a,a,a,a,a,a,a,a,a,s,
d,a,e,a,a,a,a,a,a,a,a,a,a,a,a,s,s,a,a,s,
d,a,e,s,a,a,a,a,a,a,a,s,s,s,s,s,s,a,a,s,
d,a,e,s,a,a,a,a,a,a,a,a,a,a,s,a,a,a,a,p,
d,a,e,a,a,a,e,a,e,a,a,a,a,a,a,a,s,a,a,s,
d,a,e,s,s,a,a,e,a,a,a,a,a,a,a,a,a,a,a,s,
d,a,e,s,a,a,e,a,e,a,a,a,a,a,a,a,a,a,a,s,
s,s,s,s,s,s,s,s,s,s,s,s,s,s,s,s,s,s,s,s,
