m,m,m,m,m,m,m,m,m,m,m,m,m,m,m,m,m,m,m,m,
m,a,s,s,a,a,a,a,m,e,a,a,a,a,e,a,a,a,a,m,
m,a,s,s,a,a,a,a,m,a,a,a,a,a,a,a,a,a,a,m,
m,a,a,m,m,a,a,a,m,a,a,a,a,a,a,a,m,m,e,m,
m,m,a,m,m,a,s,s,m,a,a,a,a,a,e,a,m,m,a,m,
d,a,a,a,a,a,s,s,m,a,b,m,m,m,m,a,a,a,a,m,
d,a,a,a,a,a,a,a,a,a,a,a,a,a,m,a,a,e,a,m,
d,a,a,c,c,a,a,a,a,a,a,a,a,a,m,m,m,a,a,m,
m,m,a,c,c,a,a,a,a,a,a,a,a,a,m,m,a,a,e,m,
m,a,a,a,a,a,a,a,a,a,a,a,a,a,m,a,m,a,a,m,
m,m,m,m,m,m,m,a,p,a,m,m,m,m,m,m,m,m,m,m,
