s,s,s,s,s,s,s,s,s,s,s,s,s,s,s,s,s,s,s,s,
a,a,s,s,a,a,a,a,a,m,a,a,a,a,a,a,a,a,a,s,
a,a,s,s,a,a,a,a,a,m,a,a,a,a,a,a,a,a,a,s,
a,a,a,s,a,a,m,m,s,m,a,m,m,a,a,a,a,a,a,s,
a,s,a,a,a,m,s,s,e,m,e,a,a,m,a,m,m,a,a,s,
a,a,a,a,m,m,m,m,m,m,m,m,m,m,a,m,m,a,a,s,
a,a,a,a,m,a,e,a,a,d,a,a,e,m,s,a,a,a,a,s,
a,a,a,a,m,a,a,a,a,d,a,a,a,m,s,s,s,a,a,s,
p,s,a,a,m,m,m,m,a,m,a,m,m,a,s,s,a,a,a,s,
a,a,a,a,a,a,a,a,a,m,e,a,a,a,s,a,m,a,a,m,
s,s,s,s,s,s,s,s,s,s,s,s,s,s,s,s,s,s,s,s,
