a,s,s,s,s,s,s,s,s,a,
a,a,a,a,a,a,a,a,a,a,
a,a,a,a,a,a,a,a,a,a,
a,a,a,a,a,a,a,a,a,p,
a,a,a,a,a,a,a,a,a,p,
a,a,a,a,s,a,a,a,a,p,
a,a,a,a,a,a,a,a,a,p,
a,s,a,a,a,a,a,a,s,a,
a,s,s,s,s,s,s,s,s,s,
a,s,s,s,s,s,s,s,s,s,
