s,s,s,s,s,s,s,s,s,s,s,s,s,s,s,s,s,s,s,s,
s,a,a,a,a,a,a,a,s,e,a,a,a,a,a,a,a,a,a,s,
s,a,a,a,a,a,a,a,s,a,a,a,a,a,a,a,a,a,a,s,
s,a,a,m,m,a,a,a,s,a,a,a,a,a,a,a,m,m,a,s,
s,a,a,m,m,a,c,c,s,a,a,a,a,a,a,a,m,m,a,s,
l,a,a,a,a,a,c,c,s,a,a,s,s,s,s,a,a,a,a,s,
l,a,a,a,a,a,a,a,a,a,a,a,a,a,s,a,a,a,a,s,
l,a,a,g,a,a,a,a,a,a,a,a,a,a,s,m,m,a,a,s,
s,a,a,a,a,a,a,a,a,a,a,a,a,a,s,m,m,a,a,s,
s,s,s,s,s,s,s,a,p,a,s,s,s,s,s,s,s,s,s,s,
