a,s,s,s,s,s,s,s,s,a,d,s,
a,a,a,a,a,a,a,a,a,a,d,s,
a,a,a,a,a,a,a,a,a,a,d,s,
a,a,a,d,a,a,e,a,a,p,d,s,
a,a,d,a,a,a,a,a,a,p,d,s,
a,a,a,a,d,a,a,a,a,p,d,s,
a,a,a,a,a,e,a,a,a,a,a,a,
a,e,a,a,e,a,a,a,e,a,a,a,a,a,a,a,a,a,a,a,a,a,a,a
a,d,d,d,d,d,d,d,d,a,a,a,
a,d,d,d,d,d,d,d,d,d,d,s,
