a,m,s,s,s,s,s,s,s,a,m,s,
a,a,a,a,a,a,a,a,a,a,m,s,
a,a,a,a,a,a,a,a,a,a,m,s,
a,a,a,a,a,a,e,a,a,a,a,a,
2,2,s,s,s,s,s,s,s,p,m,s,
2,2,s,s,s,s,m,m,m,m,m,s,
m,m,a,a,a,e,a,a,a,a,a,a,
a,e,a,a,e,a,a,a,e,a,a,a,a,a,a,a,a,a,a,a,a,a,a,a
m,m,m,m,m,m,m,m,m,m,m,m,
m,m,m,m,m,m,m,m,m,m,m,m,
