m,m,m,m,m,m,m,m,m,m,m,m,m,
m,a,a,a,a,a,a,a,a,a,a,m,m,
m,a,a,a,a,a,a,a,a,a,a,m,m,
m,a,a,a,a,a,a,a,a,a,a,m,m,
m,a,a,a,a,s,s,a,a,p,a,m,m,
m,a,a,a,a,s,s,a,a,a,a,m,m,
m,a,a,a,a,a,a,a,a,a,a,m,m,
m,a,a,a,a,a,a,a,a,a,a,m,m,
m,a,a,a,a,a,a,a,a,a,a,m,m,
m,a,a,a,a,a,a,a,a,a,a,m,m,
m,m,m,m,m,m,m,m,m,m,m,m,m,
