a,s,s,s,s,s,s,s,s,a,d,s,
a,a,a,a,a,a,a,a,a,a,d,s,
a,a,a,a,a,a,a,a,a,a,d,s,
a,a,a,d,a,a,a,a,a,p,d,s,
a,a,d,a,a,a,a,a,a,p,d,s,
a,a,a,a,d,a,a,a,a,p,d,s,
a,a,a,a,a,a,a,a,d,p,d,s,
a,s,a,a,a,a,a,a,s,a,d,s,
a,d,d,d,d,d,d,d,d,d,d,s,
a,d,d,d,d,d,d,d,d,d,d,s,
