a,s,s,s,s,s,s,s,s,a,
a,a,a,a,a,a,a,a,a,a,
a,a,a,a,a,a,a,a,a,a,
a,a,a,a,a,a,a,a,a,a,
a,a,a,a,a,a,a,a,a,a,
a,a,a,a,d,a,a,a,a,a,
a,a,a,a,a,a,a,a,a,a,
a,s,a,a,a,a,a,a,s,a,
a,d,d,d,d,d,d,d,d,d,
a,d,d,d,d,d,d,d,d,d,
