a,s,s,s,s,s,s,s,s,a,
a,a,a,a,a,a,a,a,a,a,
a,a,a,a,a,a,a,a,a,a,
a,a,a,a,a,a,a,a,a,a,
a,a,a,a,a,a,a,a,a,a,
a,a,a,a,a,a,a,a,a,a,
a,a,a,a,a,a,a,a,a,a,
a,s,a,a,a,a,a,a,s,a,
d,d,d,d,d,d,d,d,d,d,
d,d,d,d,d,d,d,d,d,d,
