s,s,s,s,s,s,s,s,s,s,s,s,s,s,s,s,s,s,s,s,
s,g,s,s,a,a,a,a,p,a,a,a,a,a,a,a,a,a,a,s,
s,a,s,s,a,a,a,a,a,a,a,a,a,a,a,a,a,a,a,s,
s,a,a,s,s,a,a,a,s,a,a,a,a,a,a,a,a,a,a,s,
s,s,a,c,c,a,s,s,s,a,a,a,a,a,a,m,m,a,a,s,
s,a,e,a,a,a,s,s,s,a,a,s,a,a,a,m,m,a,a,s,
s,a,a,s,a,a,s,a,a,a,a,a,a,a,s,a,a,a,a,s,
d,l,a,m,m,a,a,a,a,a,e,a,a,a,s,s,s,a,a,s,
d,l,a,m,m,e,a,a,a,a,a,a,a,a,s,s,a,a,a,s,
d,l,a,a,a,a,a,a,a,a,e,a,a,a,s,a,m,a,a,m,
s,s,s,s,s,s,s,s,s,s,s,s,s,s,s,s,s,s,s,s,
