s,s,s,s,s,s,s,s,s,s,s,s,s,s,s,s,s,s,s,s,
s,a,a,a,a,a,a,a,a,a,a,a,a,a,a,a,a,a,a,s,
s,a,s,s,s,s,s,s,a,a,a,a,a,a,a,a,a,a,l,d,
s,a,s,s,s,s,s,s,a,a,a,a,a,a,a,a,e,a,l,d,
s,a,a,a,a,a,a,s,c,m,c,m,m,t,a,a,a,a,l,d,
s,s,a,a,s,s,a,a,m,a,m,a,m,a,a,a,a,a,a,s,
s,a,a,a,a,s,a,s,c,m,c,a,m,a,m,a,a,a,a,s,
s,a,a,e,a,s,a,s,a,a,a,a,m,a,m,a,e,m,e,s,
s,a,e,c,c,s,a,s,a,e,a,a,m,m,m,a,a,m,m,s,
s,m,a,c,c,s,p,s,s,s,a,a,a,a,a,a,a,e,m,s,
s,s,s,s,s,s,s,s,s,s,s,s,s,s,s,s,s,s,s,s,
