s,s,s,s,s,s,s,s,s,s,s,s,s,s,s,s,s,s,s,s,
d,l,e,a,a,a,a,a,a,a,a,a,a,a,a,a,a,a,a,s,
d,l,e,s,a,a,a,a,a,a,a,a,a,a,a,a,a,a,a,s,
d,l,e,s,s,a,a,a,s,a,a,a,a,a,a,a,a,a,a,s,
d,l,e,a,a,a,a,a,a,a,a,a,a,a,a,s,s,a,a,s,
d,l,e,s,a,a,a,a,a,a,a,s,s,s,s,s,s,a,a,s,
d,l,e,s,a,a,a,a,a,a,a,a,a,a,s,a,a,p,a,s,
d,l,e,a,a,a,e,a,e,a,a,a,a,a,a,a,s,a,a,s,
d,l,e,s,s,a,a,e,a,a,a,a,a,a,a,a,a,a,a,s,
d,l,e,s,a,a,e,a,e,a,a,a,a,a,a,a,a,a,a,s,
s,s,s,s,s,s,s,s,s,s,s,s,s,s,s,s,s,s,s,s,
