s,s,s,s,s,s,s,s,s,s,s,s,s,s,s,s,s,s,s,s,
s,c,c,c,a,m,a,a,a,e,a,a,a,m,m,m,a,a,a,s,
s,c,c,c,a,a,a,a,a,a,a,a,a,a,a,a,m,e,a,s,
s,a,a,a,a,m,m,m,m,m,m,m,m,m,a,a,m,a,e,s,
s,m,m,m,m,m,m,a,m,a,m,a,a,m,a,m,m,m,a,s,
s,m,a,a,a,a,a,a,a,a,a,a,a,a,a,a,a,m,a,s,
p,a,a,a,a,m,m,m,m,m,m,m,m,m,m,m,a,m,m,s,
s,m,m,m,a,m,a,m,a,m,a,a,a,a,a,m,a,a,m,s,
s,a,a,m,a,m,m,m,m,m,a,a,a,a,a,m,a,a,a,d,
s,a,a,a,a,a,a,a,a,a,m,m,m,m,a,m,m,m,m,s,
s,s,s,s,s,s,s,s,s,s,s,s,s,s,s,s,s,s,s,s,
