s,s,s,s,s,s,s,s,d,d,d,s,s,s,s,s,s,s,s,s,
s,m,a,c,c,c,a,a,l,l,l,a,a,a,a,a,a,a,m,s,
s,m,m,c,c,c,a,a,a,a,a,a,a,a,a,a,a,m,m,s,
s,a,m,c,c,c,a,a,a,a,a,a,a,a,a,a,a,m,a,s,
s,a,a,a,a,a,a,a,a,a,b1,a,a,a,a,a,a,a,a,s,
s,a,a,t,a,a,a,a,a,a,a,a,a,a,a,a,a,a,a,s,
s,a,a,a,a,a,a,a,a,a,a,a,a,t,a,a,a,a,a,s,
s,a,m,a,a,a,a,a,a,a,a,a,a,a,a,a,a,m,a,s,
s,m,m,a,a,a,a,a,a,a,a,a,a,a,a,a,a,m,m,s,
s,m,a,a,a,a,a,a,a,a,p,a,a,a,a,a,a,a,m,s,
s,s,s,s,s,s,s,s,s,s,s,s,a,s,s,s,s,s,s,s,
