s,s,s,s,s,s,s,s,s,s,s,s,s,s,s,s,s,s,s,s,
s,c,c,m,a,s,a,a,t,e,a,a,a,s,s,s,a,a,a,s,
s,c,m,c,a,a,a,a,a,a,a,e,a,a,a,a,a,e,a,s,
s,a,a,a,a,s,a,a,a,a,s,s,s,s,a,a,a,a,a,s,
s,s,s,s,s,s,s,a,s,a,s,a,a,s,a,a,s,s,a,s,
s,s,a,a,a,a,a,a,a,a,a,a,a,a,a,a,a,s,a,s,
s,p,a,a,a,s,s,s,s,s,a,a,a,s,s,s,a,s,s,s,
s,s,s,s,a,s,a,s,a,s,a,c,c,a,a,s,a,a,s,s,
s,a,a,s,a,s,s,s,s,s,a,c,c,a,a,s,a,a,l,d,
s,a,a,a,a,a,a,a,a,a,s,s,s,s,a,s,s,s,s,s,
s,s,s,s,s,s,s,s,s,s,s,s,s,s,s,s,s,s,s,s,
