s,s,s,s,s,s,s,s,s,s,s,s,s,s,s,s,s,s,s,s,
s,a,c,c,a,a,a,a,s,a,a,a,a,a,a,a,a,a,a,s,
s,a,c,c,a,a,a,a,s,a,a,t,a,a,a,a,a,a,a,s,
s,a,a,m,m,a,a,a,s,a,a,a,a,a,a,a,m,m,a,s,
s,s,a,m,m,a,c,c,s,a,a,a,a,a,a,a,m,m,a,s,
d,l,a,a,a,a,c,c,s,a,b,s,s,s,s,a,t,a,a,s,
d,l,a,a,a,a,a,e,a,a,a,a,a,a,s,a,a,a,a,s,
d,l,a,a,a,a,a,a,a,a,a,a,a,a,s,m,m,a,a,s,
s,s,a,a,a,a,a,a,p,a,a,a,a,a,s,c,c,a,a,s,
s,a,a,a,a,a,a,a,a,a,a,a,a,a,s,c,c,a,a,s,
s,s,s,s,s,s,s,s,s,s,s,s,s,s,s,s,s,s,s,s,
