s,s,s,s,s,s,s,d,d,d,s,s,s,s,s,s,s,s,s,s,
s,c,c,s,a,a,s,l,l,l,a,a,a,a,a,a,a,a,a,s,
s,a,a,a,a,a,a,a,a,a,a,a,a,a,a,a,a,a,a,s,
s,a,a,a,a,a,a,a,a,a,a,a,a,a,s,a,a,a,a,s,
s,s,s,s,s,a,a,t,a,e,a,a,a,a,s,c,c,a,a,s,
s,a,a,a,a,a,a,a,a,a,s,s,s,s,s,c,c,a,a,s,
s,a,a,e,a,a,s,a,a,a,s,c,c,a,s,a,a,p,a,s,
s,a,t,a,a,a,s,a,a,a,s,c,c,a,s,a,a,a,a,s,
s,s,a,a,a,a,s,s,s,s,a,a,a,a,s,a,a,a,a,s,
s,a,a,a,a,a,a,a,a,a,a,a,e,a,s,a,a,a,a,s,
s,s,s,s,s,s,s,s,s,s,s,s,s,s,s,s,s,s,s,s,
