s,s,s,s,s,s,s,s,s,s,s,s,s,s,s,s,s,s,s,s,
s,a,c,c,a,a,s,a,p,s,a,a,a,a,a,a,a,a,a,s,
s,a,a,c,a,a,s,a,a,s,a,a,a,e,a,a,a,a,a,s,
s,a,a,a,a,a,a,a,a,s,a,a,a,a,a,a,a,a,e,s,
s,s,s,a,a,s,s,s,s,s,a,a,a,a,a,m,m,a,a,s,
s,a,e,a,a,a,a,a,s,a,a,a,a,a,a,m,m,a,a,s,
s,s,s,s,s,s,a,a,a,a,s,s,s,s,s,a,a,a,a,s,
d,l,a,a,a,a,a,a,a,a,s,a,c,c,s,a,a,a,a,s,
d,l,a,a,a,e,a,a,a,a,a,a,a,a,s,a,m,m,a,s,
d,l,a,a,a,a,a,a,a,a,a,a,a,a,s,a,m,m,a,s,
s,s,s,s,s,s,s,s,s,s,s,s,s,s,s,s,s,s,s,s,
