s,s,s,s,s,s,s,s,s,s,s,s,s,s,s,s,s,s,s,s,
s,m,a,c,c,c,a,a,a,a,a,a,a,a,a,a,a,a,m,s,
s,m,m,c,c,c,a,a,a,a,a,a,a,a,a,a,a,m,m,s,
s,a,m,c,c,c,a,a,a,a,a,a,a,a,a,a,a,m,a,s,
s,a,a,a,a,a,a,a,a,a,b1,a,a,a,a,a,a,a,a,s,
s,a,a,a,a,a,a,a,a,a,a,a,a,a,a,a,a,a,a,s,
s,a,a,a,a,a,a,a,a,a,a,a,a,a,a,a,a,a,a,s,
s,a,m,a,a,a,a,a,a,a,a,a,a,a,a,a,a,m,a,s,
s,m,m,a,a,a,a,a,a,a,a,a,a,a,a,a,a,m,m,s,
s,m,a,a,a,a,a,a,a,a,a,a,a,a,a,a,a,a,m,s,
s,s,s,s,s,s,s,s,a,a,p,a,a,s,s,s,s,s,s,s,
