s,s,s,s,s,s,s,s,s,s,s,s,s,s,s,s,s,s,s,s,
s,m,a,a,a,a,a,a,a,a,a,a,a,a,a,a,a,a,m,s,
s,m,m,a,a,a,a,a,a,a,a,a,a,a,a,a,a,m,m,s,
s,e,m,e,a,a,e,a,a,a,a,a,a,a,a,a,e,m,e,s,
s,a,e,m,a,a,a,a,c,c,c,a,a,a,a,a,m,a,a,s,
s,a,a,a,a,a,a,a,c,p,c,a,a,a,a,a,a,a,a,s,
s,a,e,m,e,a,a,a,c,c,c,a,a,a,a,a,m,a,a,s,
s,e,m,e,a,a,a,a,a,a,a,a,a,a,a,a,e,m,e,s,
s,m,m,a,a,a,a,a,a,e,a,a,a,a,a,a,a,m,m,s,
s,m,a,a,e,a,a,l,l,l,a,a,a,a,a,a,a,e,m,s,
s,s,s,s,s,s,s,d,d,d,s,s,s,s,s,s,s,s,s,s,
