s,s,s,s,s,s,s,s,s,s,s,s,s,s,s,s,s,s,s,s,
s,a,m,m,a,a,a,a,s,a,a,a,a,a,a,a,a,a,a,s,
s,a,m,m,a,a,a,a,c,a,a,t,a,a,a,a,a,e,a,s,
s,a,a,a,a,a,a,a,c,a,a,a,a,a,a,t,a,a,a,s,
s,s,s,s,c,c,c,c,s,a,a,a,a,a,a,a,a,a,a,s,
d,l,a,a,a,a,a,a,s,s,s,s,s,s,s,a,a,a,a,s,
d,l,a,a,a,a,a,a,a,a,tp,a,a,a,s,a,a,a,a,s,
d,l,a,a,a,a,a,a,a,a,a,a,a,a,s,a,a,a,a,s,
s,s,s,s,s,s,s,s,s,p,a,a,a,a,s,a,a,t,a,s,
d,a,c,a,a,c,a,c,a,a,a,a,a,a,s,a,a,a,a,s,
s,s,s,s,s,s,s,s,s,s,s,s,s,s,s,s,s,s,s,s,
