s,s,s,s,s,s,s,d,d,d,s,s,s,s,s,s,s,s,s,s,
s,a,s,s,a,a,a,l,l,l,a,a,a,a,a,a,a,a,a,s,
s,a,s,s,a,a,a,a,a,a,a,a,a,a,a,a,a,a,a,s,
s,a,a,s,s,a,a,a,s,a,a,a,a,a,a,a,a,a,a,s,
s,s,a,s,s,a,s,s,s,a,a,a,a,a,a,c,c,a,a,s,
s,a,a,a,a,a,s,s,s,a,a,s,s,s,s,c,c,a,a,s,
s,a,a,e,a,a,a,a,a,a,a,a,a,a,s,a,a,p,a,s,
s,a,a,c,c,a,a,a,a,a,a,a,a,a,s,s,s,a,a,s,
s,s,a,c,c,a,a,a,a,a,a,a,a,a,s,s,a,a,a,s,
s,a,a,a,a,a,a,a,a,a,a,a,a,a,s,a,s,a,a,s,
s,s,s,s,s,s,s,s,s,s,s,s,s,s,s,s,s,s,s,s,
