s,s,s,s,s,s,s,s,s,s,s,s,s,s,s,s,s,s,s,s,
s,s,a,s,a,a,a,a,a,a,a,s,l,l,l,s,a,a,a,s,
s,s,a,s,a,a,a,e,a,e,a,s,l,g,l,s,a,a,a,s,
s,s,a,s,s,a,a,a,e,a,a,s,l,l,l,s,a,a,a,s,
d,l,a,a,a,a,a,e,a,e,a,a,a,a,a,s,s,a,a,s,
d,l,a,s,a,a,a,a,a,a,a,s,s,s,s,s,s,a,a,s,
d,l,a,s,a,a,a,a,a,a,a,a,a,a,s,a,a,p,a,s,
s,s,a,a,a,a,e,a,e,a,a,a,a,e,a,e,s,a,a,s,
s,s,a,s,s,a,a,e,a,a,a,a,a,a,e,a,a,a,a,s,
s,s,a,s,a,a,e,a,e,a,a,a,a,e,a,e,a,a,a,s,
s,s,s,s,s,s,s,s,s,s,s,s,s,s,s,s,s,s,s,s,
