s,s,s,s,s,s,s,s,s,s,s,s,s,s,s,s,s,s,s,s,
s,a,s,a,a,a,a,a,p,s,a,a,a,a,a,a,a,a,a,s,
s,a,s,a,a,a,a,a,s,a,a,a,a,a,a,a,a,a,a,s,
s,a,a,a,a,a,a,a,s,a,a,a,a,a,a,a,a,a,a,s,
s,s,a,a,a,a,a,s,a,a,a,a,a,a,a,m,m,a,a,s,
s,a,e,a,a,a,s,s,s,a,a,s,a,a,a,m,m,a,a,s,
s,a,a,s,a,a,s,a,a,a,a,a,a,a,s,a,a,a,a,s,
d,l,a,a,a,a,a,a,a,a,e,a,a,a,s,s,s,a,a,s,
d,l,a,a,a,e,a,a,a,a,s,a,a,a,s,s,a,a,a,s,
d,l,a,a,a,a,a,a,a,a,e,a,a,a,s,a,m,a,a,m,
s,s,s,s,s,s,s,s,s,s,s,s,s,s,s,s,s,s,s,s,
