s,s,s,s,s,s,s,s,s,s,s,s,s,s,s,s,s,s,s,s,
a,a,s,s,a,a,a,a,a,m,a,a,a,a,a,a,a,a,a,s,
a,a,s,s,a,a,a,a,a,m,a,a,a,a,a,a,a,a,a,s,
a,a,a,s,a,a,m,a,a,a,a,m,m,a,a,a,a,a,a,s,
a,s,a,a,a,m,a,a,e,a,e,a,a,m,a,m,m,a,a,s,
a,a,a,a,m,m,m,m,m,s,m,m,m,m,a,m,m,a,a,s,
a,a,a,a,m,a,e,a,l,d,s,a,e,m,s,a,a,a,a,s,
a,a,a,a,m,a,a,a,l,d,s,a,a,a,s,s,s,a,a,s,
p,s,a,a,m,a,a,a,a,s,a,a,a,a,s,s,a,a,a,s,
a,a,a,a,a,a,a,a,a,a,e,a,a,a,s,a,m,a,a,m,
s,s,s,s,s,s,s,s,s,s,s,s,s,s,s,s,s,s,s,s,
