s,s,s,s,s,s,s,s,s,s,s,s,s,s,s,s,s,s,s,s,
s,a,c,c,a,a,a,a,s,e,a,a,a,a,e,a,a,a,a,s,
s,a,c,c,a,a,a,a,s,a,a,a,a,a,a,a,a,a,a,s,
s,a,a,m,m,a,a,a,s,a,a,a,a,a,a,a,m,m,e,s,
s,s,a,m,m,a,c,c,s,a,a,a,a,a,e,a,m,m,a,s,
d,a,a,a,a,a,c,c,s,a,b,s,s,s,s,a,a,a,a,s,
d,a,a,a,a,a,a,a,a,a,a,a,a,a,s,a,a,e,a,s,
d,a,a,a,a,a,a,a,a,a,a,a,a,a,s,m,m,a,a,s,
s,s,a,a,a,a,a,a,a,a,a,a,a,a,s,m,c,a,e,s,
s,a,a,a,a,a,a,a,a,a,a,a,a,a,s,c,m,a,a,s,
s,s,s,s,s,s,s,a,p,a,s,s,s,s,s,s,s,s,s,s,
