s,s,s,s,s,s,s,s,s,s,s,s,s,s,s,s,s,s,s,s,
s,m,m,m,m,m,m,m,m,m,m,m,m,m,m,m,m,m,m,s,
s,m,s,s,a,a,a,a,a,a,p,a,a,a,e,a,a,a,m,s,
s,m,a,s,a,a,a,a,a,a,a,a,a,a,a,a,a,a,m,s,
s,m,a,a,a,a,a,a,e,a,e,a,a,a,a,a,a,a,m,s,
s,m,a,a,a,a,a,a,a,a,a,a,a,a,a,a,a,a,m,s,
s,m,a,a,a,a,e,a,a,a,a,a,e,a,a,a,a,a,m,s,
s,m,a,a,a,a,a,a,a,a,a,a,a,a,a,a,a,a,m,s,
s,m,a,a,a,a,a,a,a,s,a,a,a,a,a,a,a,a,m,s,
s,m,m,m,m,m,m,l,l,l,m,m,m,m,m,m,m,m,m,s,
s,s,s,s,s,s,s,d,d,d,s,s,s,s,s,s,s,s,s,s,
