s,s,s,s,s,s,s,s,s,s,s,s,s,s,s,s,s,s,s,s,
s,m,a,a,a,a,a,a,a,a,a,a,a,a,a,a,e,a,m,s,
s,m,m,a,a,a,a,a,a,a,a,a,a,a,a,a,a,m,m,s,
s,e,m,a,a,a,e,a,a,a,a,a,a,a,a,a,a,m,e,s,
s,a,a,m,a,a,a,a,a,a,a,a,a,a,a,a,m,a,a,s,
s,b1,a,a,m,a,a,a,a,p,a,a,a,a,a,m,a,a,b1,s,
s,a,a,m,e,a,a,a,a,a,a,a,a,a,a,a,m,a,a,s,
s,e,m,a,a,a,a,a,a,a,a,a,a,a,a,a,a,m,e,s,
s,m,m,a,a,a,a,a,a,e,a,a,a,a,a,a,a,m,m,s,
s,m,a,a,a,a,a,a,a,a,a,a,a,a,a,a,a,a,m,s,
s,s,s,s,s,s,s,s,s,d,s,s,s,s,s,s,s,s,s,s,
